NO ./images/blackstone.png
SO ./images/qdenizar.png
WE ./images/blackstone.png
EA ./images/qdenizar.png

F 150,150,150
C 10,100,200

        1111111111111111 11111111
        1000000000000001110000001
        1011000000000000000000001
        1001000000000000000000001
11111111101100000000000S000000001
100000000000000000000000000000001
100000000000000011111111111111101
100000000000000000000000000000001
100000000000000000000000000000001
100000000000000000000000000000001
100000000000000000000000000000001
111111111111111111111111111111111

