NO ./images/pink.png
SO ./images/pink2.png
WE ./images/blackstone.png
EA ./images/qdenizar.png

F 250,100,200
C 255,192,203

        1111111111111111 11111111
        1000000001000001110000001
        1011000001000000000000001
        1001000001000000000000001
111111111011000000000000000000001
100000000000000000000000000000001
100000000000000011111111111111101
100000000000000000000000000000001
100000000000000000000000000000001
100000000000000000000000000000001
100000000000000000000000000000001
1000000000000000000000000000000011
100000000000000000000000000000001
100000000000000000000000000000001
100000000000000000000000000000001
100000000000000000000000000000001
100000000000000S00000000000000001
100000000000000000000000000000001
100000000000000000000000000000001
100000000000000000000000000000001
100000000000000000000000000000001
100000000000000000000000000000001
100000000000000000000000000000001
100000000000000000000000000000001
111111111111111111111111111111111

