NO ./images/pink_grand.png
SO ./images/pink2_grand.png
WE ./images/chabrune3.png
EA ./images/emuller_dark.png

F 250,100,200
C 255,192,203

        1111111111111111 11111111
        1000000001000001110000001
        1011000001000000000000001
        1001000001000000000000001
111111111011000000000000000000001
100000000000000000000000000000001
100000000000000011111111111111101
100000000000000000000000000000001
100000000000000000000000000000001
100000000000000000000000000000001
100000000000001000000000000000001
100000000000010100000000000000001
100000000000001000000000000000001
100000000000000000000000000000001
100000000000000000000000000000001
100000000000000011111110000000001
1000000000000001      10000000001
1000000000000001      10000000001
100000000000000011111110000000001
100000000000000000000000000000001
100000000000000000000000000000001
100000000000000E00000000000000001
111111111110000000000000000000001
100000000000000000000000000000001
100000000000000000000000000000001
100000000000000000000000000000001
100000000000000000000000000000001
100000000000000000000000000000001
100000000000000000000000000000001
100000000000000000000000000000001
100000000000000000000000000000001
100000000000000000000000000000001
100000000000000000000000000000001
100000000000000000000000000000001
100000000000000000000000000000001
100000000000000000000000000000001
100000000000000000000000000000001
100000000000000000000000000000001
100000000000000000000000000000001
100000000000000000000000000000001
100000000000000000000000000000001
100000000000000000000000000000001
100000000000000000000000000000001
100000000000000000000000000000001
100000000000000000000000000000001
100000000000000000000000000000001
100000000000000000000000000000001
100000000000000000000000000000001
100000000000000000000000000000001
100000000000000000000000000000001
100000000000000000000000000000001
100000000000000000000000000000001
100000000000000000000000000000001
100000000000000000000000000000001
100000000000000000000000000000001
100000000000000000000000000000001
100000000000000000000000000000001
100000000000000000000000000000001
100000000000000000000000000000001
100000000000000000000000000000001
100000000000000000000000000000001
100000000000000000000000000000001
100000000000000000000000000000001
100000000000000000000000000000001
100000000000000000000000000000001
100000000000000000000000000000001
100000000000000000000000000000001
100000000000000000000000000000001
100000000000000000000000000000001
100000000000000000000000000000001
100000000000000000000000000000001
100000000000000000000000000000001
100000000000000000000000000000001
100000000000000000000000000000001
100000000000000000000000000000001
100000000000000000000000000000001
100000000000000000000000000000001
100000000000111111111111111100001
100000000000000000000000000000001
100000000000000000000000000000001
111111111111111111111111111111111

