NO ./path_to_the_north_texture
SO ./path_to_the_south_texture
WE ./path_to_the_west_texture
EA ./path_to_the_east_texture

F 150,150,150
C 10,100,200

        1111111111111111 11111111
        1000000000110001110000001
        1011000001110000000000001
        1001000000000000N00000001
111111111011000001110000000000001
100000000011000001110000111111111
11110111111111011100000010001
11110111111111011101010010001
11000000110101011100000010001
10000000000010000000000000001
10000000000000001101010010001
1100000111010101111101111000011
11110111 11101011101111010001
11111111 1111111 11111111111

