NO    ./images/pink2_grand.png
SO ./images/pink2_grand.png
WE ./images/pink2_grand.png
EA ./images/chabrune2.png

F 220,100,0
C 225,30,0

11111111111111111111111111111111111111
10000000000000000000000000000000000001
10000000000000000000000000000000000001
10000000000000000001110000000000000001
10000000000000000010001000000000000001
10000000000000000010001000000000000001
1000000000000N000010001000000000000001
10000000000000000001110000000000000001
10000000000000000000000000000000000001
10000000000000000000000000000000000001
10000000000000000000000000000000000001
10000000001111111100000000000000000001
10000000001111111100000000000000000001
10000000001111111100000000000000000001
10000000000000000000000000000000000001
10000000000000000000000000000000000001
10000000000000000000000000000000000001
10000000000000000000000000000000000001
10000000000000000000000000000000000001
10000000000000000000000000000000000001
10000000001111111111111111111111111111
10000000000000000000000000000000000001
10000000000000000000000000000000000001
11111111111111111111110000000000000001
10000000000000000000000000000000000001
10000000000000000000000000000000000001
10000000000000000000000000000000000001
10000000000000000000000000000000000001
10000000000000000000000000000000000001
10000000000000000000000000000000000001
10000000000000000000000000000000000001
10000000000000000000000000000000000001
10000000000000000000000000000000000001
11111111111111111111111111111111111111
