NO      ./path_to_the_north_texture
SO ./path_to_the_south_texture
WE ./path_to_the_west_texture
EA ./path_to_the_east_texture

F 220,100,0
C 225,30,0

1111111111111111111111111111111
1000000000000000000000000000001
1001111111010000100001110000001
1E01000000010000100010001000001
1001000000010000100100000100001
1001000000011111100111111100001
1001000000010000100100000100001
1001111111010000100100000100001
1000000000000000000000000000001
1111111111111111111111111111111
